w,w,w,w,w,w,w,w,w,w,w,w,w,
w,,+,pd,,pl,,pd,,pl,,w,w,
w,,w,,,,,,,,w,w,w,w
w,,w,w,w,,,w,,,,,,w
w,pl,,,w,,,w,,w,w,,,w
w,w,w,+,w,w,,,w,w,w,w,,w
w,w,w,,,+,,,,w,ke,w,+,w
w,,,,,w,,,,,,,,w
w,w,w,w,w,w,,w,w,w,w,w,w,w
,w,,,,,+,w,,,,,,
,w,,,,,w,w,,,,,,
,w,w,w,-,w,w,w,,,,,,
,w,w,w,,s,w,,,,,,,
,,w,w,w,w,w,,,,,,,
